Test Level
stage main 13 7
    1 1 1 1 1 1 1 1 1 1 1 1 1
    1 0 0 0 0 0 2 0 0 0 0 0 1
    1 0 0 0 0 0 1 0 0 0 0 0 1
    1 0 0 1 0 0 1 0 0 1 0 0 1
    1 0 0 0 0 0 1 0 0 0 0 0 1
    1 0 0 0 0 0 1 0 0 0 0 0 1
    1 1 1 1 1 1 1 1 1 1 1 1 1
stage digital 14 5
    1 1 1 1 1 1 1 1 1 1 1 1 1 1
    1 0 0 0 0 0 1 1 0 0 0 0 0 1
    1 0 0 1 0 0 1 1 0 0 1 0 0 1
    1 0 0 0 0 0 1 1 0 0 0 0 0 1
    1 1 1 1 1 1 1 1 1 1 1 1 1 1
link main 4 3 digital 3 3
link main 4 9 digital 3 10
link digital 1 5 digital 1 8
switch main 1 9 toggledoor main 1 6
